###################################################
#                 #         #                   # #
######### ####### ### # ### # # ############### # #
#     #   #     #   # # #   # #       #       #   #
# ### # ### ### ### ### # ### ####### # ##### #####
# # # # #     #   #   # # #   #     #     # #     #
# # # # ####### # ### # ### ##### ####### # ##### #
# #     #   #   # #   #     #     #     # #     # #
# ####### # # # ### ### ####### # # ### # ##### # #
#   #   # #   # #   # # #       # # # # # #     # #
### # # # # ##### ### # # # ##### # # # # # ##### #
#   # #   # #   # #   # # #     # # #   #   #     #
# ### ####### # # # ### # ##### # # ### ##### ### #
# #         # #   #   # #   # # # #   #   #   #   #
# ######### # ##### # # ### # # # ### ### # ### ###
# #     #   # #   # #   # #   # #   # #     #   # #
# # ### # # # # # # ##### # ### ### # # ####### # #
# #   # # # # # # #   #     #   #   # # #     #   #
# ### # # ### # # ### ####### ### ### ### ### #####
#   # # # #   # #   #       #   #   #       #     #
### # # # # ##### # ####### ### ### ############# #
#   # # #       # #             #     #     #     #
# ### # ####### ##### ######### ##### # ### # #####
#     #   #   # #   #   #   #   #   # # # # #     #
# ####### ### # # # ##### # ##### # ### # # # ### #
#   #   #   #     #   #   #   #   #     #   # #   #
### # # ### # ####### # ##### # ######### ### # ###
#   # #   # # #   #     #     # #   #   # #   #   #
# ####### # ### # ####### ##### ### # # # ####### #
#         # #   #   #   #     #   # # #   #   #   #
########### # ##### # # ##### ### # # ##### # # ###
#           #   # #   #     # #   #         # #   #
# ######### ### # ######### # # ############# ### #
#     #   # #       #       # #             #     #
# ### # # ### ####### ####### ############# ##### #
# # #   #     #     #   #   #             #   #   #
# # ########### ### # # # # ############# ### # ###
#           # # # # # # # #   #     #   # #   #   #
######### ### # # # ### # ### # ### # # # # ##### #
# #   #   #   # # #   #   #   # #   # # #   #     #
# # # # ### ### # ### ##### ### ##### # ##### #####
# # #   # # #   #         # #   #     #     #     #
# # ##### # # # ######### # # ### ####### ####### #
# # #     # # #     #   # # #   # #     #       # #
# # # ### # ####### ### # # ### # ### ######### # #
# # #   # #       #   #   # #   #   #         # # #
# # # # # ####### ### # ### # ##### # ####### # # #
# # # # # #     #     #   # # #   # # #       #   #
# # ### # # ### ######### # # # # # ### ##### #####
#       #   #           #   #   #       #         #
###################################################
